NO ./texture/nord_debug.jpg
SO ./texture/sud_debug.jpg
WE ./texture/ouest_debug.jpg
EA ./texture/est_debug.jpg
F 220,100,0
C 225,30,0

11111
10X01
11N11
11111
