NO ./texture/nord_debug.jpg
SO ./texture/sud_debug.jpg
WE ./texture/ouest_debug.jpg
EA ./texture/est_debug.jpg

F 220,100,0
C 225,30,0

        111111111
        1000000011111
111111111011000000001
100000000011000000001
101111111111111111111
101        10001
1011111111110101
1000000000000N01

1111111111111111
